XXXXXXXX
XS  XX X
XXX XX X
X X    X
X XXX XX
X      X
X X XXGX
XXXXXXXX